###########
#P...#....#
#.###.#.###
#...#.#...#
###.#.###.#
#...#.....#
#.#######.#
#.#.......#
#.#.#####.#
#...#....X#
###########