###########
#P..#.....#
#.#.#.###.#
#.#...#...#
#.#####.###
#.....#...#
###.#.###.#
#...#...#.#
#.#####.#.#
#.......#X#
###########