####################
#P....#....#......X#
#.###.#.##.#.#######
#...#.#..#.#......##
###.#.##.#.######.##
#...#....#....#...##
#.######.####.#.#.##
#......#....#.#.#.##
#.####.#.##.#.#.#.##
#.#..#.#.o#.#.#.#.##
#.#..#.####.#.#.#.##
#.#........#.#.#S.##
#.##########.#.##.##
#..............S...#
####################