##########
#P......X#
#.######.#
#........#
#.######.#
#........#
#.######.#
#....C...#
##########