###########
#P........#
#.#######.#
#.#.....#.#
#.#.###.#.#
#...#...#.#
###.#.###.#
#...#.....#
#.#######.#
#........X#
###########