####################
#P..#......#......X#
##.#.#######.###.#.#
#..#.....#.....#.#.#
#.#####.#.#.###.#..#
#.....#.#.#...#.#..#
#.###.#.#.###.#.##.#
#.#...#...#...#....#
#.#.#######.######.#
#.#.......o.....#S.#
#.#######.#####.#..#
#.......#.....#.#..#
#.#####.#####.#.##.#
#.............#....#
####################