####################
#P....#.......#...X#
#.##.#.#####.#.##..#
#....#...#...#..#..#
#.######.#.####.#.##
#......#.#....#.#..#
#.####.#.####.#.##.#
#.#....#....#.#....#
#.#.######.#.#.###.#
#...#..o...#...#S..#
###.#.#########.#.##
#...#.....#.....#..#
#.#######.#.######.#
#.........#........#
####################