###########
#P....#...#
#####.#.#.#
#.....#.#.#
#.#####.#.#
#.#.....#.#
#.#.#####.#
#.#...#...#
#.###.#.###
#.....#..X#
###########